Foreign State;Immediate Relatives;Special Immigrants;Family Preference;Employment Preference;Immigrants;Total
Afghanistan;401;10107;193;0;83;10784
Albania;1098;12;339;96;249;1794
Algeria;656;13;404;42;807;1922
Andorra;0;0;0;0;0;0
Angola;27;0;16;1;8;52
Antigua and Barbuda;92;0;47;5;2;146
Argentina;393;22;74;37;82;608
Armenia;646;9;210;26;101;992
Australia;330;23;14;34;104;505
Austria;59;15;12;6;12;104
Azerbaijan;113;0;10;10;175;308
Bahamas, The;192;0;43;50;18;303
Bahrain;30;0;5;30;1;66
Bangladesh;3826;30;1553;94;0;5503
Barbados;86;3;58;23;0;170
Belarus;233;3;61;8;482;787
Belgium;75;4;6;20;9;114
Belize;163;0;111;4;0;278
Benin;205;2;68;11;57;343
Bhutan;17;0;0;0;18;35
Bolivia;340;3;265;17;17;642
Bosnia and Herzegovina;123;5;75;14;14;231
Botswana;19;0;1;1;0;21
Brazil;1928;25;224;246;0;2423
Brunei;0;0;0;4;0;4
Bulgaria;345;14;42;14;78;493
Burkina Faso;168;0;57;31;3;259
Burma;310;15;153;15;94;587
Burundi;44;0;11;0;43;98
Cabo Verde;260;10;320;7;0;597
Cambodia;1097;9;220;210;50;1586
Cameroon;1818;22;535;30;643;3048
Canada;1280;16;91;77;0;1464
Central African Republic;18;0;4;0;0;22
Chad;26;0;3;3;25;57
Chile;269;7;90;30;20;416
China - mainland born;7912;223;9018;1348;0;18501
Colombia;3988;171;538;88;0;4785
Comoros;0;0;0;0;0;0
Congo, Dem. Rep. of the;409;4;162;38;590;1203
Congo, Rep. of the;56;0;3;0;49;108
Costa Rica;480;1;31;11;14;537
Cote d'Ivoire;470;6;304;7;137;924
Croatia;43;2;17;17;17;96
Cuba;2004;3;707;1;517;3232
Cyprus;16;3;5;4;0;28
Czech Republic;64;9;16;8;8;105
Denmark;31;0;1;4;0;36
Djibouti;35;1;4;5;35;80
Dominica;156;0;117;5;1;279
Dominican Republic;12370;9;5492;70;0;17941
Ecuador;3017;14;1915;14;101;5061
Egypt;1244;16;303;245;422;2230
El Salvador;5268;11;2449;85;0;7813
Equatorial Guinea;2;0;0;0;1;3
Eritrea;234;11;95;16;15;371
Estonia;25;2;11;9;1;48
Eswatini;2;0;0;0;0;2
Ethiopia;1324;16;689;318;55;2402
Fiji;122;8;102;0;290;522
Finland;59;4;10;11;5;89
France;363;25;62;134;38;622
Gabon;28;1;13;0;7;49
Gambia, The;413;6;47;18;0;484
Georgia;293;11;35;52;261;652
Germany;786;39;102;89;70;1086
Ghana;1390;20;420;183;203;2216
Great Britain and Northern Ireland;1602;33;110;152;0;1897
Greece;120;7;18;17;6;168
Grenada;135;0;79;17;0;231
Guatemala;2123;22;548;24;0;2717
Guinea-Bissau;7;0;1;0;0;8
Guinea;387;1;49;22;41;500
Guyana;1450;10;1154;35;1;2650
Haiti;2669;10;1068;52;0;3799
Honduras;2403;8;690;35;44;3180
Hong Kong S.A.R.;434;13;215;38;138;838
Hungary;127;9;7;10;50;203
Iceland;16;0;3;13;4;36
India;6382;558;1182;1153;0;9275
Indonesia;398;33;193;18;72;714
Iran;1332;16;978;287;189;2802
Iraq;375;94;82;6;22;579
Ireland;188;3;5;11;6;213
Israel;353;16;31;39;32;471
Italy;373;32;55;71;91;622
Jamaica;2763;23;877;712;0;4375
Japan;977;64;103;78;179;1401
Jordan;1580;14;566;105;520;2785
Kazakhstan;193;9;74;16;292;584
Kenya;755;26;169;407;255;1612
Kiribati;0;0;0;0;0;0
Korea, North;6;1;0;0;1;8
Korea, South;1630;42;276;1006;0;2954
Kosovo;242;0;98;68;112;520
Kuwait;174;6;116;69;47;412
Kyrgyzstan;160;2;67;11;352;592
Laos;9;1;1;0;0;11
Latvia;86;0;17;6;22;131
Lebanon;916;23;315;189;100;1543
Lesotho;4;0;0;0;0;4
Liberia;645;3;88;21;46;803
Libya;158;0;20;6;49;233
Liechtenstein;0;0;0;0;0;0
Lithuania;83;6;26;19;43;177
Luxembourg;1;1;0;0;0;2
Madagascar;22;0;7;3;4;36
Malawi;43;2;7;11;2;65
Malaysia;146;17;117;41;9;330
Maldives;2;0;0;0;0;2
Mali;176;0;14;0;6;196
Malta;4;0;1;0;0;5
Marshall Islands;1;0;0;0;0;1
Mauritania;48;0;8;0;6;62
Mauritius;9;0;0;0;0;9
Mexico;30844;25;9599;129;0;40597
Micronesia, Federated States of;2;0;0;0;0;2
Moldova;267;12;153;11;168;611
Monaco;0;0;0;1;0;1
Mongolia;61;12;80;20;182;355
Montenegro;75;0;68;0;5;148
Morocco;2060;34;362;16;1113;3585
Mozambique;10;0;0;0;0;10
Namibia;9;0;0;1;0;10
Nauru;0;0;0;0;0;0
Nepal;2795;182;811;226;1328;5342
Netherlands;147;6;9;13;7;182
New Zealand;86;5;9;15;90;205
Nicaragua;1889;11;1232;33;51;3216
Niger;78;0;19;9;6;112
Nigeria;3378;14;1032;566;0;4990
North Macedonia;263;2;120;27;60;472
Northern Ireland (DV only);0;0;0;0;0;0
Norway;21;1;0;1;0;23
Oman;9;0;7;19;3;38
Pakistan;4452;70;2305;386;0;7213
Palau;1;0;0;0;0;1
Panama;223;5;122;10;3;363
Papua New Guinea;4;0;0;1;1;6
Paraguay;71;2;37;1;0;111
Peru;642;162;309;19;640;1772
Philippines;8189;34;1364;6275;0;15862
Poland;427;74;228;135;78;942
Portugal;72;3;26;15;4;120
Qatar;56;0;34;91;9;190
Romania;323;42;196;43;102;706
Russia;588;29;124;97;316;1154
Rwanda;93;0;48;3;147;291
Saint Kitts and Nevis;52;1;27;0;0;80
Saint Lucia;131;0;114;47;0;292
Saint Vincent and the Grenadines;88;2;15;8;0;113
Samoa;6;0;2;0;1;9
San Marino;0;0;0;0;0;0
Sao Tome and Principe;1;0;0;0;0;1
Saudi Arabia;391;40;70;93;107;701
Senegal;453;8;77;19;9;566
Serbia;187;2;95;22;22;328
Seychelles;0;0;0;0;0;0
Sierra Leone;999;2;396;14;70;1481
Singapore;79;10;22;33;4;148
Slovakia;42;5;12;15;3;77
Slovenia;13;0;1;13;5;32
Solomon Islands;1;0;0;0;0;1
Somalia;617;1;100;2;4;724
South Africa;424;7;48;25;95;599
South Sudan;37;0;1;0;3;41
Spain;272;10;66;28;34;410
Sri Lanka;331;6;20;49;393;799
Sudan;481;5;25;26;246;783
Suriname;28;0;14;3;0;45
Sweden;102;2;5;9;5;123
Switzerland;98;9;7;14;14;142
Syria;400;7;247;27;76;757
Tajikistan;117;2;76;12;237;444
Tanzania;195;2;76;9;19;301
Thailand;1077;45;29;42;28;1221
Timor-Leste;1;0;0;0;0;1
Togo;475;2;319;10;183;989
Tonga;22;0;8;0;11;41
Trinidad and Tobago;496;52;150;77;18;793
Tunisia;171;3;38;32;54;298
Turkey;660;26;130;77;468;1361
Turkmenistan;20;2;33;7;222;284
Tuvalu;0;0;0;0;0;0
Uganda;161;3;37;25;55;281
Ukraine;1581;21;431;123;863;3019
United Arab Emirates;213;16;68;261;40;598
Uruguay;97;1;38;6;2;144
Uzbekistan;245;9;177;1;81;513
Vanuatu;1;0;0;0;0;1
Vatican City;0;0;0;0;0;0
Venezuela;1190;6;238;124;473;2031
Vietnam2;6587;118;2857;833;0;10458
Yemen;3070;9;1297;172;222;4770
Zambia;90;6;32;15;9;152
Zimbabwe;153;3;55;266;66;543
