Foreign State;Immediate Relatives;Special Immigrants;Family Preference;Employment Preference;Immigrants;Total
Afghanistan;771;10087;563;17;687;12125
Albania;1291;10;1706;169;2047;5223
Algeria;316;29;190;49;2380;2964
Andorra;1;0;0;0;0;1
Angola;19;0;18;8;291;336
Antigua and Barbuda;52;3;45;7;0;107
Argentina;337;16;208;254;92;907
Armenia;595;12;527;116;1282;2532
Australia;191;70;80;40;375;756
Austria;46;7;5;11;18;87
Azerbaijan;102;0;68;62;713;945
Bahamas, The;102;0;37;51;9;199
Bahrain;23;0;6;8;4;41
Bangladesh;6283;222;2645;220;0;9370
Barbados;50;7;51;6;0;114
Belarus;138;5;171;51;852;1217
Belgium;54;5;5;19;16;99
Belize;113;2;75;12;0;202
Benin;185;0;154;10;264;613
Bhutan;26;0;0;9;76;111
Bolivia;289;3;315;36;28;671
Bosnia and Herzegovina;77;1;82;17;61;238
Botswana;11;2;3;2;4;22
Brazil;2386;55;1156;2637;0;6234
Brunei;2;1;2;6;1;12
Bulgaria;222;46;182;33;142;625
Burkina Faso;127;1;91;15;43;277
Burma;411;15;270;76;419;1191
Burundi;75;0;21;13;140;249
Cabo Verde;493;8;371;20;0;892
Cambodia;1285;19;1243;187;166;2900
Cameroon;1240;11;1272;54;1703;4280
Canada;1239;4;387;342;0;1972
Central African Republic;6;1;2;3;7;19
Chad;16;1;7;0;136;160
Chile;166;8;79;41;10;304
China - mainland born;5467;103;7600;8938;0;22108
Colombia;3741;93;4824;231;0;8889
Comoros;0;0;0;0;0;0
Congo, Dem. Rep. of the;400;11;627;26;898;1962
Congo, Rep. of the;44;2;11;60;136;253
Costa Rica;395;6;284;28;3;716
Cote d'Ivoire;341;4;265;8;375;993
Croatia;35;3;7;10;14;69
Cuba;11684;13;10790;18;612;23117
Cyprus;7;1;3;5;5;21
Czech Republic;59;7;18;28;6;118
Denmark;63;2;7;19;6;97
Djibouti;22;0;14;1;77;114
Dominica;97;0;145;8;1;251
Dominican Republic;20214;32;12918;53;0;33217
Ecuador;1880;23;4225;116;160;6404
Egypt;2271;35;629;265;2093;5293
El Salvador;4762;32;10273;195;0;15262
Equatorial Guinea;4;0;2;0;0;6
Eritrea;326;17;150;37;57;587
Estonia;18;1;1;4;10;34
Eswatini;4;1;1;5;0;11
Ethiopia;2020;31;1509;140;595;4295
Fiji;73;10;270;6;537;896
Finland;39;7;2;7;12;67
France;304;33;171;174;99;781
Gabon;14;0;14;1;18;47
Gambia, The;460;0;34;5;40;539
Georgia;296;7;266;117;1272;1958
Germany;621;37;135;113;283;1189
Ghana;2239;10;384;410;330;3373
Great Britain and Northern Ireland;1138;45;379;550;0;2112
Greece;76;10;45;19;51;201
Grenada;87;1;105;10;0;203
Guatemala;3972;8;3612;86;0;7678
Guinea-Bissau;12;0;1;1;10;24
Guinea;508;0;29;14;376;927
Guyana;603;8;1353;12;1;1977
Haiti;3527;21;1435;140;0;5123
Honduras;3813;12;3680;96;0;7601
Hong Kong S.A.R.;349;16;735;224;0;1324
Hungary;87;6;38;33;65;229
Iceland;11;0;0;5;5;21
India;12481;711;9147;3294;0;25633
Indonesia;197;42;128;18;96;481
Iran;2899;40;1778;529;1989;7235
Iraq;886;265;301;21;645;2118
Ireland;106;4;27;58;12;207
Israel;327;10;109;115;47;608
Italy;357;22;129;207;143;858
Jamaica;5259;19;4270;622;0;10170
Japan;847;120;68;265;292;1592
Jordan;1542;22;1147;244;686;3641
Kazakhstan;183;2;61;37;832;1115
Kenya;1023;30;410;1255;1125;3843
Kiribati;0;0;0;0;0;0
Korea, North;2;0;0;0;0;2
Korea, South;1177;32;859;2948;0;5016
Kosovo;193;2;288;21;295;799
Kuwait;166;4;168;67;92;497
Kyrgyzstan;141;1;63;17;1388;1610
Laos;351;21;70;12;11;465
Latvia;38;1;15;12;26;92
Lebanon;1092;25;823;193;203;2336
Lesotho;6;0;0;0;0;6
Liberia;463;3;158;10;530;1164
Libya;262;3;31;3;189;488
Liechtenstein;0;0;0;0;0;0
Lithuania;50;3;49;18;73;193
Luxembourg;2;0;0;0;0;2
Madagascar;13;0;7;24;5;49
Malawi;34;0;11;12;12;69
Malaysia;116;46;86;54;28;330
Maldives;1;0;0;0;0;1
Mali;168;0;5;7;45;225
Malta;5;0;2;0;0;7
Marshall Islands;0;0;0;0;0;0
Mauritania;80;0;2;0;86;168
Mauritius;11;0;4;2;2;19
Mexico;44855;57;20316;1300;0;66528
Micronesia, Federated States of;1;0;0;0;0;1
Moldova;210;11;139;8;478;846
Monaco;0;0;0;0;0;0
Mongolia;53;12;20;40;182;307
Montenegro;46;2;64;1;31;144
Morocco;788;15;673;35;2554;4065
Mozambique;15;0;0;0;1;16
Namibia;11;0;6;2;5;24
Nauru;0;0;3;0;0;3
Nepal;1628;150;2202;496;3301;7777
Netherlands;91;6;16;31;13;157
New Zealand;90;16;15;18;101;240
Nicaragua;1089;24;895;45;14;2067
Niger;43;3;9;4;32;91
Nigeria;2332;31;654;1592;0;4609
North Macedonia;172;8;269;46;223;718
Norway;52;3;11;18;4;88
Oman;11;2;4;17;16;50
Pakistan;3543;167;2389;533;0;6632
Palau;1;0;0;2;0;3
Panama;160;9;151;9;4;333
Papua New Guinea;3;0;0;1;9;13
Paraguay;58;1;27;10;0;96
Peru;2866;304;1124;54;119;4467
Philippines;7420;81;3330;16570;0;27401
Poland;181;88;363;284;183;1099
Portugal;58;2;45;22;11;138
Qatar;32;17;25;98;55;227
Romania;215;28;98;44;182;567
Russia;1081;15;515;401;2642;4654
Rwanda;78;1;101;34;655;869
Saint Kitts and Nevis;41;2;33;0;0;76
Saint Lucia;107;0;141;8;0;256
Saint Vincent and the Grenadines;54;2;69;9;0;134
Samoa;9;0;3;0;1;13
San Marino;0;0;0;0;0;0
Sao Tome and Principe;8;0;2;0;0;10
Saudi Arabia;324;19;223;313;440;1319
Senegal;593;2;67;22;108;792
Serbia;142;2;88;44;146;422
Seychelles;2;0;2;0;4;8
Sierra Leone;1023;5;437;29;207;1701
Singapore;69;18;34;84;13;218
Slovakia;43;1;11;3;20;78
Slovenia;16;3;1;2;2;24
Solomon Islands;0;0;0;1;0;1
Somalia;504;2;157;1;82;746
South Africa;343;7;163;496;243;1252
South Sudan;43;0;1;7;18;69
Spain;217;7;70;132;79;505
Sri Lanka;336;14;413;131;560;1454
Sudan;292;7;78;10;1697;2084
Suriname;15;0;15;0;0;30
Sweden;94;3;31;44;11;183
Switzerland;79;0;8;13;14;114
Syria;863;9;746;73;238;1929
Taiwan;467;125;477;448;230;1747
Tajikistan;110;2;64;72;711;959
Tanzania;118;2;31;29;60;240
Thailand;934;77;413;227;122;1773
Timor-Leste;0;0;0;0;0;0
Togo;470;4;498;20;836;1828
Tonga;42;3;36;0;27;108
Trinidad and Tobago;397;174;719;115;16;1421
Tunisia;98;4;27;22;134;285
Turkey;341;43;257;193;1186;2020
Turkmenistan;46;34;45;33;546;704
Tuvalu;0;0;0;0;0;0
Uganda;287;1;67;77;192;624
Ukraine;1737;24;1667;150;2542;6120
United Arab Emirates;143;118;101;751;79;1192
Uruguay;57;4;18;20;0;99
Uzbekistan;568;14;1949;29;2399;4959
Vanuatu;0;0;0;0;0;0
Vatican City;0;0;0;0;0;0
Venezuela;1204;12;1135;352;795;3498
Vietnam2;9052;374;11525;1454;0;22573
Yemen;2172;2;2123;305;620;5222
Zambia;50;0;23;45;30;148
Zimbabwe;113;3;57;672;138;983
